NO         textures/1.png
		SO  	 	textures/2.png
	EA 	 	 	textures/3.png
	WE  	 	 textures/4.png

F  	  255,255,255
C    200 , 220 , 255


111111111111111111111         
1000W0000000000000001
1001111000000000000011
10010010000000000000101
1001001000000011111111
 1101101111111
   1  1
 11 11 111111111111 

