11111111111111111111111111
10000011111000000000000011
1100001   1000000000000011
10000011111000000000000001
10000011000000000000000001
11111111111111111111111111